20 20
0 0
19 19
5 1 1 3 1 1 11 13 5 3 1 1 3 11 13 5 11 13 7 9
12 12 4 11 14 6 3 2 2 9 14 4 1 9 12 12 13 12 5 10
12 12 6 1 3 3 3 3 11 6 11 14 12 4 2 0 2 2 2 11
12 12 5 0 3 3 1 9 13 5 3 11 14 14 7 0 3 1 1 9
12 14 14 4 1 9 12 14 12 4 9 5 11 7 3 0 11 12 12 14
4 1 9 12 14 14 4 3 8 12 14 4 11 5 11 14 13 14 4 9
12 14 14 4 11 7 10 7 8 4 1 0 11 4 11 5 2 11 12 12
4 3 9 6 3 1 11 7 0 8 14 4 3 0 3 2 1 11 14 14
4 9 6 9 5 2 3 9 14 4 11 14 13 6 1 11 6 9 5 11
12 6 9 14 4 11 13 12 7 0 1 1 2 9 4 9 7 8 4 9
6 9 4 11 4 1 10 4 11 14 12 6 11 14 14 12 7 0 10 12
5 10 6 11 12 6 11 6 3 9 4 1 1 1 11 6 11 4 11 12
4 1 11 7 0 3 1 1 11 12 12 14 14 14 13 5 11 14 5 8
12 4 9 7 10 13 12 6 11 14 4 3 11 5 10 6 3 1 10 12
14 12 14 5 3 2 0 1 11 5 2 1 1 10 7 3 3 8 7 10
13 12 13 6 11 5 8 4 9 4 11 14 4 3 11 13 13 4 11 13
4 0 0 11 5 10 12 12 12 4 3 9 6 1 11 4 10 6 3 10
12 12 6 11 14 7 8 12 14 6 9 6 9 4 1 2 3 3 3 11
14 4 3 9 7 1 8 14 5 1 2 11 12 14 6 3 3 11 5 11
7 2 11 6 11 14 6 11 14 6 3 11 6 3 3 3 3 3 2 11
